 # # # # # # # # #
#. . . . . . . . .#

#. . . . . . . . .#

#. . . . . . . . .#

#. . . . . . . . .#

#. . . . . . . . .#

#. . . .#. . . . .#

#. . . .#. . . . .#
 # # # # # # # ^ #
---
10 shelf
1 armchair
1 couch
