   # # #
  #. . .#

  #. . .#
 #
>. . . .#
 #
  #. . .#
   # # # 
---
2 bed
3 plant
