 # # # # # #  
#. . . . . .#

#. . . . . .#

#. . . . . .#

#. . #

>. . #

>. . #

#. . . . . . #

#. . . . . . #

#. . . . . . #

#. . . . . . #
 # # # # # # 
---
2 officechair
1 table
4 shelf
1 armchair
1 couch
3 plant
3 desk
