 # # # # #
#. . . . .#

=. . . . .#

#. . . . .#

#. . . . .=

#. . . . .#

#. . . . .#

#. . . . .#
 # # ^ # #
---
8 plant
8 shelf
