             # # #
            #. . .#
             #
              #. .#
     # # # # #
    #. . . . . . .#
               # #
    #. . . . .#
 # #
#. . . . . . .#
               #
>. . . . . . . .#
     # # #
#. .#     #. . .#
 # #       # # #
---
1 bed
3 shelf
1 armchair
1 couch
5 plant
1 desk
