 # # # # # # # #
#. . . . . . . .#

#. . . . . . . .#
     # # # #
#. .#. . . .#. .#

#. .#. . . .#. .#
     # #
#. . . . . .#. .#

#. . . . . .#. .#
 # # # # # #
      >. . . . .#

      >. . . . .#
       # # # # #
---
1 bed
