 # # # # #
#. . . . .#

#. . . . .<

#. . . . .#

#. . . . .#

#. . . . .#

#. . . . .#

#. . . . .#
 # ^ # ^ #
---
10 couch
1 desk
1 officechair
